6
1 10 1 1800 900 0 0 0 0 2
2 11 1 700 900 0 0 0 0 2
3 12 1 600 900 0 0 0 0 2
4 13 1 500 900 0 0 0 0 2
5 13 1 400 1000 0 0 0 0 2
6 13 1 300 1000 0 0 0 0 2
