5
1 10 1 200 900 0 0 0 0 2
2 10 1 300 900 0 0 0 0 2
3 10 1 700 900 0 0 0 0 2 
4 10 1 800 900 0 0 0 0 2
5 10 1 1800 900 0 0 0 0 2


