0
1 17 1 600 900 0 0 0 0 2
2 17 1 500 900 0 0 0 0 2
3 17 1 400 900 0 0 0 0 2
4 17 1 300 900 1000 1000 0 0 2
5 17 1 100 1050 0 0 0 0 2
6 17 1 400 1050 0 0 0 0 2
7 17 1 700 1050 0 0 0 0 2
